PPPPPPPPPPPPPPPPPPPPPPPPPPPPPPPPPPPPPPPPPPPPPPPPPPPPPPPPPPPPPPPPPPPPPPPPPPPPPPPPPPPPPPPPPPPPPPPPPPPPPPPPPPPPP
P   PPPPPPPPPPPPPPPPPPPPPPP                                                       PPPPPPPPPPPPPPPPPPPPPPPPPPP
P   PPPPPPPPPPPPPPPPPPPPPPP                                                       PPPPPPPPPPPPPPPPPPPPPPPPPPP
P   PPPPPPPPPPPPPPPPPPPPPPP                    PPPPPPPPPPP                        PPPPPPPPPPPPPPPPPPPPPPPPPPP
P   PPPPPPPPPPPPPPPPPPPPPPP                                     P                 PPPPPPPPPPPPPPPPPPPPPPPPPPP
P   PPPPPPPPPPPPPPPPPPPPPPP       PPPPPP                        P                 PPPPPPPPPPPPPPPPPPPPPPPPPPP
P   PPPPPPPPPPPPPPPPPPPPPPP                                     P                 PPPPPPPPPPPPPPPPPPPPPPPPPPP
P   PPPPPPPPPPPPPPPPPPPPPPP                                     P                 PPPPPPPPPPPPPPPPPPPPPPPPPPP
P   PPPPPPPPPPPPPPPPPPPPPPP                  PPPPPP             P                 PPPPPPPPPPPPPPPPPPPPPPPPPPP
P                                                               P                 PPPPPPPPPPPPPPPPPPPPPPPPPPP
P                                                               P                 PPPPPPPPPPPPPPPPPPPPPPPPPPP
P                               PPPPPPP                         P                 PPPPPPPPPPPPPPPPPPPPPPPPPPP
P                                                               P                 PPPPPPPPPPPPPPPPPPPPPPPPPPP
PPPPPPPPPEEEPPPPPPEEEPPPPPPPPPPEEEEEEEEEEEEEEEEEEEEEEEEEEEEEEEEEE22222222222222222PPPPPPPPPPPPPPPPPPPPPPPPPPP
PPPPPPPPPPPPPPPPPPPPPPPPPPPPPPPPPPPPPPPPPPPPPPPPPPPPPPPPPPPPPPPPPPPPPPPPPPPPPPPPPPPPPPPPPPPPPPPPPPPPPPPPPPPPP
PPPPPPPPPPPPPPPPPPPPPPPPPPPPPPPPPPPPPPPPPPPPPPPPPPPPPPPPPPPPPPPPPPPPPPPPPPPPPPPPPPPPPPPPPPPPPPPPPPPPPPPPPPPPP
PPPPPPPPPPPPPPPPPPPPPPPPPPPPPPPPPPPPPPPPPPPPPPPPPPPPPPPPPPPPPPPPPPPPPPPPPPPPPPPPPPPPPPPPPPPPPPPPPPPPPPPPPPPPP
PPPPPPPPPPPPPPPPPPPPPPPPPPPPPPPPPPPPPPPPPPPPPPPPPPPPPPPPPPPPPPPPPPPPPPPPPPPPPPPPPPPPPPPPPPPPPPPPPPPPPPPPPPPPP
PPPPPPPPPPPPPPPPPPPPPPPPPPPPPPPPPPPPPPPPPPPPPPPPPPPPPPPPPPPPPPPPPPPPPPPPPPPPPPPPPPPPPPPPPPPPPPPPPPPPPPPPPPPPP
PPPPPPPPPPPPPPPPPPPPPPPPPPPPPPPPPPPPPPPPPPPPPPPPPPPPPPPPPPPPPPPPPPPPPPPPPPPPPPPPPPPPPPPPPPPPPPPPPPPPPPPPPPPPP
PPPPPPPPPPPPPPPPPPPPPPPPPPPPPPPPPPPPPPPPPPPPPPPPPPPPPPPPPPPPPPPPPPPPPPPPPPPPPPPPPPPPPPPPPPPPPPPPPPPPPPPPPPPPP
PPPPPPPPPPPPPPPPPPPPPPPPPPPPPPPPPPPPPPPPPPPPPPPPPPPPPPPPPPPPPPPPPPPPPPPPPPPPPPPPPPPPPPPPPPPPPPPPPPPPPPPPPPPPP
PPPPPPPPPPPPPPPPPPPPPPPPPPPPPPPPPPPPPPPPPPPPPPPPPPPPPPPPPPPPPPPPPPPPPPPPPPPPPPPPPPPPPPPPPPPPPPPPPPPPPPPPPPPPP
PPPPPPPPPPPPPPPPPPPPPPPPPPPPPPPPPPPPPPPPPPPPPPPPPPPPPPPPPPPPPPPPPPPPPPPPPPPPPPPPPPPPPPPPPPPPPPPPPPPPPPPPPPPPP
PPPPPPPPPPPPPPPPPPPPPPPPPPPPPPPPPPPPPPPPPPPPPPPPPPPPPPPPPPPPPPPPPPPPPPPPPPPPPPPPPPPPPPPPPPPPPPPPPPPPPPPPPPPPP
PPPPPPPPPPPPPPPPPPPPPPPPPPPPPPPPPPPPPPPPPPPPPPPPPPPPPPPPPPPPPPPPPPPPPPPPPPPPPPPPPPPPPPPPPPPPPPPPPPPPPPPPPPPPP